

NO textures/wall.xpm
SO textures/brick.xpm
WE textures/planks.xpm
EA textures/greystone.xpm

F 220,111,119
C 225,111,0

          
     11111  
    100S001
     1w001
      101
       1
