
NO textures/brick.xpm
SO textures/greystone.xpm
WE textures/planks.xpm
EA textures/wall.xpm

F 77,92,53
C 163,208,100

111111
100111
101001
1101N1
111111
