
NO textures/brick.xpm
SO textures/greystone.xpm
WE textures/planks.xpm
EA textures/wall.xpm

F 77,92,53
C 163,208,100

1111111
1010001
11N0001
1000001
1111111
